,Geographic Area Name,2010,2018,change,tract,geometry
0,"Census Tract 101, San Francisco County, California",54095,67377,13282,101.0,"POLYGON ((-122.420612315115 37.8111121700604, -122.407452 37.81144099999999, -122.399638840473 37.8065658502084, -122.401787 37.805314, -122.403495 37.805089, -122.405174 37.804763, -122.406625 37.804535, -122.408332 37.804367, -122.411581 37.803963, -122.414877 37.803542, -122.416888 37.805212, -122.418718 37.805932, -122.419224 37.808453, -122.420612315115 37.8111121700604))"
1,"Census Tract 102, San Francisco County, California",89096,134176,45080,102.0,"POLYGON ((-122.426671 37.809639, -122.424876 37.810799, -122.425041162157 37.811001508766, -122.420612315115 37.8111121700604, -122.419224 37.808453, -122.418718 37.805932, -122.418281 37.804023, -122.417799 37.801267, -122.417587 37.800341, -122.420769 37.79993899999999, -122.420883 37.799902, -122.424275 37.799472, -122.424464 37.800402, -122.424835 37.802268, -122.425209 37.804133, -122.425628 37.806456, -122.426613 37.808152, -122.426671 37.809639))"
2,"Census Tract 103, San Francisco County, California",99840,138630,38790,103.0,"POLYGON ((-122.418718 37.805932, -122.416888 37.805212, -122.414877 37.803542, -122.412908 37.802184, -122.412849 37.801893, -122.412471 37.800032, -122.412283 37.799096, -122.417218 37.798472, -122.417385 37.799414, -122.417587 37.800341, -122.417799 37.801267, -122.418281 37.804023, -122.418718 37.805932))"
3,"Census Tract 104, San Francisco County, California",77857,111105,33248,104.0,"POLYGON ((-122.414877 37.803542, -122.411581 37.803963, -122.408332 37.804367, -122.406625 37.804535, -122.405174 37.804763, -122.404798 37.802901, -122.40316 37.803098, -122.40279 37.80124199999999, -122.402421 37.799382, -122.405645 37.798969, -122.406024 37.800835, -122.406199 37.80172, -122.40777 37.801571, -122.411019 37.80117, -122.411376 37.801125, -122.412908 37.802184, -122.414877 37.803542))"
4,"Census Tract 105, San Francisco County, California",117115,125511,8396,105.0,"POLYGON ((-122.405174 37.804763, -122.403495 37.805089, -122.401787 37.805314, -122.399638840473 37.8065658502084, -122.398139 37.80563, -122.394407919349 37.8012904644048, -122.389708268207 37.7958244063587, -122.391487 37.793859, -122.393181 37.79323, -122.394748 37.79448, -122.396315 37.793337, -122.396586 37.794588, -122.400149 37.794134, -122.400681 37.796777, -122.402041 37.797505, -122.402421 37.799382, -122.40279 37.80124199999999, -122.40316 37.803098, -122.404798 37.802901, -122.405174 37.804763))"
5,"Census Tract 106, San Francisco County, California",27611,40380,12769,106.0,"POLYGON ((-122.411019 37.80117, -122.40777 37.801571, -122.406199 37.80172, -122.406024 37.800835, -122.405645 37.798969, -122.402421 37.799382, -122.402041 37.797505, -122.405513 37.797065, -122.406668 37.797865, -122.407083 37.798152, -122.407869 37.798697, -122.409014 37.79949, -122.411376 37.801125, -122.411019 37.80117))"
6,"Census Tract 107, San Francisco County, California",22828,25502,2674,107.0,"POLYGON ((-122.412908 37.802184, -122.411376 37.801125, -122.409014 37.79949, -122.407869 37.798697, -122.407083 37.798152, -122.406668 37.797865, -122.405513 37.797065, -122.408431 37.796704, -122.411719 37.796291, -122.411911 37.797245, -122.412283 37.799096, -122.412471 37.800032, -122.412849 37.801893, -122.412908 37.802184))"
7,"Census Tract 108, San Francisco County, California",76147,102243,26096,108.0,"POLYGON ((-122.417218 37.798472, -122.412283 37.799096, -122.411911 37.797245, -122.411719 37.796291, -122.411364 37.794527, -122.415218 37.79402899999999, -122.416292 37.793892, -122.416473 37.794777, -122.416653 37.79567, -122.416839 37.796596, -122.417218 37.798472))"
8,"Census Tract 109, San Francisco County, California",94063,145417,51354,109.0,"POLYGON ((-122.424275 37.799472, -122.420883 37.799902, -122.420769 37.79993899999999, -122.417587 37.800341, -122.417385 37.799414, -122.417218 37.798472, -122.416839 37.796596, -122.421768 37.795945, -122.423481 37.795739, -122.423705 37.796678, -122.424275 37.799472))"
9,"Census Tract 110, San Francisco County, California",53542,121299,67757,110.0,"POLYGON ((-122.423481 37.795739, -122.421768 37.795945, -122.416839 37.796596, -122.416653 37.79567, -122.416473 37.794777, -122.416292 37.793892, -122.416113 37.793014, -122.422801 37.792161, -122.423143 37.793923, -122.423283 37.79481, -122.423481 37.795739))"
10,"Census Tract 111, San Francisco County, California",49506,105561,56055,111.0,"POLYGON ((-122.422801 37.792161, -122.416113 37.793014, -122.415936 37.792133, -122.41575 37.791206, -122.415559 37.790254, -122.415372 37.78932, -122.422077 37.788474, -122.422237 37.789399, -122.42242 37.790358, -122.422611 37.791277, -122.422801 37.792161))"
11,"Census Tract 112, San Francisco County, California",70941,113214,42273,112.0,"POLYGON ((-122.416292 37.793892, -122.415218 37.79402899999999, -122.411364 37.794527, -122.409722 37.794737, -122.409541 37.793852, -122.409171 37.792043, -122.412461 37.791627, -122.41575 37.791206, -122.415936 37.792133, -122.416113 37.793014, -122.416292 37.793892))"
12,"Census Tract 113, San Francisco County, California",17165,37991,20826,113.0,"POLYGON ((-122.411719 37.796291, -122.408431 37.796704, -122.408253 37.795824, -122.407903 37.79406, -122.407536 37.792249, -122.409171 37.792043, -122.409541 37.793852, -122.409722 37.794737, -122.411364 37.794527, -122.411719 37.796291))"
13,"Census Tract 117, San Francisco County, California",23165,63958,40793,117.0,"POLYGON ((-122.408786 37.79016, -122.407149 37.790366, -122.40734 37.791296, -122.407536 37.792249, -122.404418 37.792639, -122.404613 37.793565, -122.400149 37.794134, -122.396586 37.794588, -122.396315 37.793337, -122.399195 37.791058, -122.406062 37.785757, -122.407451 37.784604, -122.407853 37.785492, -122.408227 37.787359, -122.408402 37.788293, -122.408786 37.79016))"
14,"Census Tract 118, San Francisco County, California",23779,29338,5559,118.0,"POLYGON ((-122.407903 37.79406, -122.404796 37.794453, -122.404613 37.793565, -122.404418 37.792639, -122.407536 37.792249, -122.407903 37.79406))"
15,"Census Tract 119.01, San Francisco County, California",50769,97109,46340,119.01,"POLYGON ((-122.41575 37.791206, -122.412461 37.791627, -122.412266 37.790673, -122.412076 37.78973999999999, -122.415372 37.78932, -122.415559 37.790254, -122.41575 37.791206))"
16,"Census Tract 119.02, San Francisco County, California",51029,84167,33138,119.02,"POLYGON ((-122.412461 37.791627, -122.409171 37.792043, -122.407536 37.792249, -122.40734 37.791296, -122.407149 37.790366, -122.408786 37.79016, -122.412076 37.78973999999999, -122.412266 37.790673, -122.412461 37.791627))"
17,"Census Tract 120, San Francisco County, California",33703,48113,14410,120.0,"POLYGON ((-122.422077 37.788474, -122.415372 37.78932, -122.415185 37.788388, -122.414995 37.787454, -122.418271 37.787038, -122.421461 37.786632, -122.421858 37.787535, -122.422077 37.788474))"
18,"Census Tract 121, San Francisco County, California",28966,72806,43840,121.0,"POLYGON ((-122.415372 37.78932, -122.412076 37.78973999999999, -122.408786 37.79016, -122.408402 37.788293, -122.411699 37.787872, -122.413354 37.787664, -122.414995 37.787454, -122.415185 37.788388, -122.415372 37.78932))"
19,"Census Tract 122.01, San Francisco County, California",31265,66563,35298,122.01,"POLYGON ((-122.418271 37.787038, -122.414995 37.787454, -122.414617 37.785582, -122.41443 37.784657, -122.416072 37.784449, -122.417707 37.784236, -122.417901 37.785167, -122.418271 37.787038))"
20,"Census Tract 122.02, San Francisco County, California",23716,35970,12254,122.02,"POLYGON ((-122.421461 37.786632, -122.418271 37.787038, -122.417901 37.785167, -122.417707 37.784236, -122.421069 37.783816, -122.421256 37.784745, -122.421461 37.786632))"
21,"Census Tract 123.01, San Francisco County, California",13615,23371,9756,123.01,"POLYGON ((-122.414617 37.785582, -122.41297 37.78579, -122.411326 37.785996, -122.411516 37.78694, -122.408227 37.787359, -122.407853 37.785492, -122.41114 37.785075, -122.412782 37.784866, -122.41443 37.784657, -122.414617 37.785582))"
22,"Census Tract 123.02, San Francisco County, California",24375,43493,19118,123.02,"POLYGON ((-122.414995 37.787454, -122.413354 37.787664, -122.411699 37.787872, -122.408402 37.788293, -122.408227 37.787359, -122.411516 37.78694, -122.411326 37.785996, -122.41297 37.78579, -122.414617 37.785582, -122.414995 37.787454))"
23,"Census Tract 124.01, San Francisco County, California",21061,24511,3450,124.01,"POLYGON ((-122.417707 37.784236, -122.416072 37.784449, -122.41443 37.784657, -122.414242 37.783724, -122.414054 37.782794, -122.413866 37.781863, -122.415505 37.781654, -122.417146 37.781447, -122.417339 37.782379, -122.417707 37.784236))"
24,"Census Tract 124.02, San Francisco County, California",18908,61736,42828,124.02,"POLYGON ((-122.421069 37.783816, -122.417707 37.784236, -122.417339 37.782379, -122.417146 37.781447, -122.415505 37.781654, -122.413866 37.781863, -122.413365 37.779862, -122.416292 37.777494, -122.417615 37.7766, -122.418704 37.775645, -122.419219 37.775316, -122.419334 37.77521, -122.419359 37.775432, -122.419765 37.777291, -122.420358 37.780072, -122.420689 37.781955, -122.421069 37.783816))"
25,"Census Tract 125.01, San Francisco County, California",11513,22150,10637,125.01,"POLYGON ((-122.414054 37.782794, -122.410765 37.783214, -122.410952 37.784141, -122.41114 37.785075, -122.407853 37.785492, -122.407451 37.784604, -122.408104 37.78402, -122.408952 37.783288, -122.410336 37.782245, -122.412548 37.780508, -122.413365 37.779862, -122.413866 37.781863, -122.414054 37.782794))"
26,"Census Tract 125.02, San Francisco County, California",11440,14976,3536,125.02,"POLYGON ((-122.41443 37.784657, -122.412782 37.784866, -122.41114 37.785075, -122.410952 37.784141, -122.410765 37.783214, -122.414054 37.782794, -122.414242 37.783724, -122.41443 37.784657))"
27,"Census Tract 126.01, San Francisco County, California",106014,143000,36986,126.01,"POLYGON ((-122.441905 37.803744, -122.437138 37.804352, -122.436799 37.802715, -122.436274 37.800814, -122.441177 37.80019, -122.441368 37.801126, -122.441754 37.802985, -122.441905 37.803744))"
28,"Census Tract 126.02, San Francisco County, California",126086,139063,12977,126.02,"POLYGON ((-122.441909 37.807316, -122.439690935158 37.8086811541357, -122.425942 37.810979, -122.425041162157 37.811001508766, -122.424876 37.810799, -122.426671 37.809639, -122.426613 37.808152, -122.425628 37.806456, -122.425209 37.804133, -122.430045 37.803518, -122.431679 37.803267, -122.436799 37.802715, -122.437138 37.804352, -122.441905 37.803744, -122.441909 37.807316))"
29,"Census Tract 127, San Francisco County, California",99861,133641,33780,127.0,"POLYGON ((-122.448241130218 37.8072521685356, -122.439690935158 37.8086811541357, -122.441909 37.807316, -122.441905 37.803744, -122.441754 37.802985, -122.441368 37.801126, -122.441177 37.80019, -122.447466 37.79939, -122.44782 37.801633, -122.449179 37.802074, -122.448241130218 37.8072521685356))"
30,"Census Tract 128, San Francisco County, California",104801,154917,50116,128.0,"POLYGON ((-122.447466 37.79939, -122.441177 37.80019, -122.436274 37.800814, -122.435678 37.798021, -122.437326 37.797811, -122.43695 37.795949, -122.438591 37.795741, -122.440234 37.795533, -122.446728 37.794706, -122.447015 37.796579, -122.447303 37.798459, -122.447466 37.79939))"
31,"Census Tract 129.01, San Francisco County, California",84949,150625,65676,129.01,"POLYGON ((-122.430045 37.803518, -122.425209 37.804133, -122.424835 37.802268, -122.424464 37.800402, -122.42929 37.799788, -122.429667 37.801654, -122.430045 37.803518))"
32,"Census Tract 129.02, San Francisco County, California",101701,128407,26706,129.02,"POLYGON ((-122.436799 37.802715, -122.431679 37.803267, -122.430045 37.803518, -122.429667 37.801654, -122.42929 37.799788, -122.424464 37.800402, -122.424275 37.799472, -122.427457 37.799067, -122.430747 37.798648, -122.432393 37.79843899999999, -122.434036 37.79823, -122.435678 37.798021, -122.436274 37.800814, -122.436799 37.802715))"
33,"Census Tract 130, San Francisco County, California",95179,161397,66218,130.0,"POLYGON ((-122.437326 37.797811, -122.435678 37.798021, -122.434036 37.79823, -122.432393 37.79843899999999, -122.430747 37.798648, -122.427457 37.799067, -122.424275 37.799472, -122.423705 37.796678, -122.426893 37.79627199999999, -122.430183 37.795854, -122.433469 37.795435, -122.435113 37.795226, -122.43695 37.795949, -122.437326 37.797811))"
34,"Census Tract 131.01, San Francisco County, California",112143,146932,34789,131.01,"POLYGON ((-122.426893 37.79627199999999, -122.423705 37.796678, -122.423481 37.795739, -122.423283 37.79481, -122.423143 37.793923, -122.422801 37.792161, -122.422611 37.791277, -122.425802 37.790874, -122.426335 37.793517, -122.426893 37.79627199999999))"
35,"Census Tract 131.02, San Francisco County, California",103614,162045,58431,131.02,"POLYGON ((-122.430183 37.795854, -122.426893 37.79627199999999, -122.426335 37.793517, -122.425802 37.790874, -122.422611 37.791277, -122.42242 37.790358, -122.425616 37.789952, -122.428905 37.789534, -122.42927 37.791339, -122.429625 37.793098, -122.430183 37.795854))"
36,"Census Tract 132, San Francisco County, California",155099,188844,33745,132.0,"POLYGON ((-122.446728 37.794706, -122.440234 37.795533, -122.438591 37.795741, -122.43695 37.795949, -122.435113 37.795226, -122.433469 37.795435, -122.430183 37.795854, -122.429625 37.793098, -122.434558 37.792472, -122.436204 37.792263, -122.437846 37.792054, -122.439488 37.791843, -122.446117 37.790999, -122.4463 37.791879, -122.446728 37.794706))"
37,"Census Tract 133, San Francisco County, California",119773,162500,42727,133.0,"POLYGON ((-122.459476 37.789711, -122.45274 37.790974, -122.4463 37.791879, -122.446117 37.790999, -122.445934 37.790119, -122.445758 37.789248, -122.445589 37.788364, -122.445402 37.787438, -122.450118 37.786838, -122.454774 37.786244, -122.45505 37.786209, -122.459179 37.785682, -122.459388 37.788405, -122.459476 37.789711))"
38,"Census Tract 134, San Francisco County, California",123462,170729,47267,134.0,"POLYGON ((-122.446117 37.790999, -122.439488 37.791843, -122.437846 37.792054, -122.436204 37.792263, -122.435849 37.790502, -122.435486 37.788697, -122.438773 37.788278, -122.440488 37.788061, -122.443753 37.787647, -122.445402 37.787438, -122.445589 37.788364, -122.445758 37.789248, -122.445934 37.790119, -122.446117 37.790999))"
39,"Census Tract 135, San Francisco County, California",101028,132750,31722,135.0,"POLYGON ((-122.436204 37.792263, -122.434558 37.792472, -122.429625 37.793098, -122.42927 37.791339, -122.428905 37.789534, -122.43384 37.788906, -122.435486 37.788697, -122.435849 37.790502, -122.436204 37.792263))"
40,"Census Tract 151, San Francisco County, California",78774,99706,20932,151.0,"POLYGON ((-122.425616 37.789952, -122.42242 37.790358, -122.422237 37.789399, -122.422077 37.788474, -122.421858 37.787535, -122.421461 37.786632, -122.421256 37.784745, -122.422838 37.784547, -122.424678 37.785291, -122.424704 37.785418, -122.425047 37.78713, -122.425616 37.789952))"
41,"Census Tract 152, San Francisco County, California",55924,91493,35569,152.0,"POLYGON ((-122.435486 37.788697, -122.43384 37.788906, -122.428905 37.789534, -122.425616 37.789952, -122.425047 37.78713, -122.428336 37.786713, -122.431635 37.786293, -122.434918 37.785876, -122.435486 37.788697))"
42,"Census Tract 153, San Francisco County, California",86094,141750,55656,153.0,"POLYGON ((-122.443753 37.787647, -122.440488 37.788061, -122.438773 37.788278, -122.435486 37.788697, -122.434918 37.785876, -122.436557 37.785668, -122.438206 37.785459, -122.443183 37.784827, -122.44337 37.785759, -122.443753 37.787647))"
43,"Census Tract 154, San Francisco County, California",82313,125651,43338,154.0,"POLYGON ((-122.459179 37.785682, -122.45505 37.786209, -122.454774 37.786244, -122.450118 37.786838, -122.445402 37.787438, -122.443753 37.787647, -122.44337 37.785759, -122.443183 37.784827, -122.44281 37.782971, -122.442793 37.782885, -122.445826 37.782512, -122.447302 37.782392, -122.454186 37.781651, -122.456304 37.78144899999999, -122.458878 37.781326, -122.458998 37.783189, -122.459179 37.785682))"
44,"Census Tract 155, San Francisco County, California",48058,64412,16354,155.0,"POLYGON ((-122.443183 37.784827, -122.438206 37.785459, -122.436557 37.785668, -122.434918 37.785876, -122.431635 37.786293, -122.428336 37.786713, -122.425047 37.78713, -122.424704 37.785418, -122.431291 37.784621, -122.434562 37.784152, -122.437863 37.783791, -122.438901 37.78344999999999, -122.44281 37.782971, -122.443183 37.784827))"
45,"Census Tract 156, San Francisco County, California",75236,95000,19764,156.0,"POLYGON ((-122.458878 37.781326, -122.456304 37.78144899999999, -122.454186 37.781651, -122.453385 37.77782699999999, -122.455217 37.777599, -122.454683 37.774755, -122.458371 37.774309, -122.458505 37.77619, -122.458878 37.781326))"
46,"Census Tract 157, San Francisco County, California",90035,116923,26888,157.0,"POLYGON ((-122.455217 37.777599, -122.453385 37.77782699999999, -122.454186 37.781651, -122.447302 37.782392, -122.445826 37.782512, -122.442793 37.782885, -122.441512 37.782096, -122.440958 37.779364, -122.442053 37.779244, -122.441866 37.7783, -122.441488 37.776435, -122.44478 37.776017, -122.446471 37.775802, -122.448068 37.775599, -122.451358 37.775175, -122.454683 37.774755, -122.455217 37.777599))"
47,"Census Tract 158.01, San Francisco County, California",46083,76689,30606,158.01,"POLYGON ((-122.44281 37.782971, -122.438901 37.78344999999999, -122.437863 37.783791, -122.434562 37.784152, -122.433973 37.781219, -122.433596 37.779355, -122.433407 37.778422, -122.436697 37.778006, -122.437072 37.779867, -122.440958 37.779364, -122.441512 37.782096, -122.442793 37.782885, -122.44281 37.782971))"
48,"Census Tract 158.02, San Francisco County, California",65417,132540,67123,158.02,"POLYGON ((-122.442053 37.779244, -122.440958 37.779364, -122.437072 37.779867, -122.436697 37.778006, -122.433407 37.778422, -122.433219 37.77749, -122.438244 37.776848, -122.441488 37.776435, -122.441866 37.7783, -122.442053 37.779244))"
49,"Census Tract 159, San Francisco County, California",39453,79698,40245,159.0,"POLYGON ((-122.434562 37.784152, -122.431291 37.784621, -122.424704 37.785418, -122.424678 37.785291, -122.424108 37.782477, -122.427396 37.782057, -122.430696 37.781635, -122.433973 37.781219, -122.434562 37.784152))"
50,"Census Tract 160, San Francisco County, California",61675,71823,10148,160.0,"POLYGON ((-122.424678 37.785291, -122.422838 37.784547, -122.421256 37.784745, -122.421069 37.783816, -122.420689 37.781955, -122.420358 37.780072, -122.423541 37.779674, -122.424108 37.782477, -122.424678 37.785291))"
51,"Census Tract 161, San Francisco County, California",20438,22500,2062,161.0,"POLYGON ((-122.433973 37.781219, -122.430696 37.781635, -122.427396 37.782057, -122.424108 37.782477, -122.423541 37.779674, -122.423354 37.778747, -122.424998 37.778538, -122.426641 37.778329, -122.429929 37.777909, -122.433219 37.77749, -122.433407 37.778422, -122.433596 37.779355, -122.433973 37.781219))"
52,"Census Tract 162, San Francisco County, California",51984,106313,54329,162.0,"POLYGON ((-122.426641 37.778329, -122.424998 37.778538, -122.423354 37.778747, -122.423541 37.779674, -122.420358 37.780072, -122.419765 37.777291, -122.419359 37.775432, -122.424246 37.774811, -122.425888 37.77459899999999, -122.426263 37.776464, -122.426641 37.778329))"
53,"Census Tract 163, San Francisco County, California",71250,148365,77115,163.0,"POLYGON ((-122.433219 37.77749, -122.429929 37.777909, -122.426641 37.778329, -122.426263 37.776464, -122.425888 37.77459899999999, -122.429178 37.774181, -122.430825 37.773973, -122.432467 37.773757, -122.433219 37.77749))"
54,"Census Tract 164, San Francisco County, California",72608,139262,66654,164.0,"POLYGON ((-122.441488 37.776435, -122.438244 37.776848, -122.433219 37.77749, -122.432467 37.773757, -122.435751 37.773346, -122.437469 37.773127, -122.440735 37.772713, -122.440922 37.773635, -122.441488 37.776435))"
55,"Census Tract 165, San Francisco County, California",84125,132750,48625,165.0,"POLYGON ((-122.454683 37.774755, -122.451358 37.775175, -122.448068 37.775599, -122.446471 37.775802, -122.44478 37.776017, -122.441488 37.776435, -122.440922 37.773635, -122.444216 37.773212, -122.447497 37.77279, -122.450787 37.772368, -122.454083 37.77193, -122.454683 37.774755))"
56,"Census Tract 166, San Francisco County, California",76597,143594,66997,166.0,"POLYGON ((-122.453902 37.771054, -122.4506 37.77146, -122.445717 37.77208, -122.440735 37.772713, -122.440358 37.770847, -122.443312 37.77047, -122.442765 37.769661, -122.44839 37.768865, -122.450522 37.768593, -122.453352 37.768246, -122.453902 37.771054))"
57,"Census Tract 167, San Francisco County, California",85177,174081,88904,167.0,"POLYGON ((-122.443866 37.767536, -122.443356 37.768944, -122.442765 37.769661, -122.443312 37.77047, -122.440358 37.770847, -122.440735 37.772713, -122.437469 37.773127, -122.435751 37.773346, -122.432467 37.773757, -122.431904 37.770964, -122.43157 37.769307, -122.433572 37.769178, -122.435794 37.769058, -122.436588 37.769001, -122.438338 37.76900699999999, -122.439301 37.768166, -122.442009 37.765907, -122.442575 37.765928, -122.443533 37.766691, -122.443866 37.767536))"
58,"Census Tract 168.01, San Francisco County, California",72724,111250,38526,168.01,"POLYGON ((-122.432467 37.773757, -122.430825 37.773973, -122.42899 37.773248, -122.428802 37.772316, -122.425512 37.772734, -122.424929 37.770778, -122.426402 37.769596, -122.42822 37.769441, -122.43157 37.769307, -122.431904 37.770964, -122.432467 37.773757))"
59,"Census Tract 168.02, San Francisco County, California",52019,96071,44052,168.02,"POLYGON ((-122.429178 37.774181, -122.425888 37.77459899999999, -122.424246 37.774811, -122.419359 37.775432, -122.419334 37.77521, -122.422186 37.772909, -122.42262 37.772503, -122.423641 37.771828, -122.424929 37.770778, -122.425512 37.772734, -122.428802 37.772316, -122.42899 37.773248, -122.430825 37.773973, -122.429178 37.774181))"
60,"Census Tract 169, San Francisco County, California",91020,115946,24926,169.0,"POLYGON ((-122.435794 37.769058, -122.433572 37.769178, -122.43157 37.769307, -122.42822 37.769441, -122.426402 37.769596, -122.426948 37.769175, -122.428635 37.767846, -122.428949 37.767504, -122.430824 37.766014, -122.435193 37.762727, -122.435472 37.765727, -122.435794 37.769058))"
61,"Census Tract 170, San Francisco County, California",100891,185435,84544,170.0,"POLYGON ((-122.446247 37.762247, -122.443538 37.765323, -122.443347 37.765333, -122.442575 37.765928, -122.442009 37.765907, -122.439301 37.768166, -122.438338 37.76900699999999, -122.436588 37.769001, -122.435794 37.769058, -122.435472 37.765727, -122.435193 37.762727, -122.435837 37.762485, -122.439491 37.762227, -122.440168 37.762187, -122.444196 37.761947, -122.446384 37.761816, -122.446247 37.762247))"
62,"Census Tract 171.01, San Francisco County, California",107308,173214,65906,171.01,"POLYGON ((-122.449433 37.7632, -122.448274 37.764196, -122.447635 37.765139, -122.448013 37.767007, -122.44839 37.768865, -122.442765 37.769661, -122.443356 37.768944, -122.443866 37.767536, -122.443533 37.766691, -122.442575 37.765928, -122.443347 37.765333, -122.443538 37.765323, -122.446247 37.762247, -122.446384 37.761816, -122.446783 37.761781, -122.44912 37.761648, -122.449433 37.7632))"
63,"Census Tract 171.02, San Francisco County, California",105684,159167,53483,171.02,"POLYGON ((-122.453352 37.768246, -122.450522 37.768593, -122.44839 37.768865, -122.448013 37.767007, -122.447635 37.765139, -122.448274 37.764196, -122.449433 37.7632, -122.44912 37.761648, -122.451958 37.761478, -122.4524 37.763669, -122.452569 37.764509, -122.452758 37.765443, -122.452947 37.766374, -122.453352 37.768246))"
64,"Census Tract 176.01, San Francisco County, California",23099,46563,23464,176.01,"POLYGON ((-122.417615 37.7766, -122.416292 37.777494, -122.413365 37.779862, -122.412548 37.780508, -122.410336 37.782245, -122.408952 37.783288, -122.408104 37.78402, -122.407451 37.784604, -122.406062 37.785757, -122.402708 37.783259, -122.404933 37.7815, -122.405719 37.780878, -122.407159 37.779739, -122.409387 37.777977, -122.411606 37.776221, -122.413161 37.774992, -122.415561 37.773101, -122.418704 37.775645, -122.417615 37.7766))"
65,"Census Tract 177, San Francisco County, California",78814,114722,35908,177.0,"POLYGON ((-122.418704 37.775645, -122.415561 37.773101, -122.41248 37.77063, -122.410931 37.769411, -122.409736 37.770349, -122.408007 37.769244, -122.40499 37.769715, -122.404497 37.764664, -122.40509 37.76462799999999, -122.408424 37.764427, -122.413003 37.764091, -122.413588 37.763823, -122.417332 37.763572, -122.417487 37.765183, -122.417802 37.768405, -122.417794 37.770435, -122.419219 37.775316, -122.418704 37.775645))"
66,"Census Tract 178.01, San Francisco County, California",18388,22450,4062,178.01,"POLYGON ((-122.404933 37.7815, -122.402708 37.783259, -122.400468 37.78503, -122.39893 37.783785, -122.397386 37.782554, -122.401843 37.779032, -122.403387 37.780265, -122.404933 37.7815))"
67,"Census Tract 178.02, San Francisco County, California",89091,74005,-15086,178.02,"POLYGON ((-122.413161 37.774992, -122.411606 37.776221, -122.409387 37.777977, -122.407159 37.779739, -122.405719 37.780878, -122.404933 37.7815, -122.403387 37.780265, -122.401843 37.779032, -122.40407 37.777273, -122.408516 37.77376, -122.41248 37.77063, -122.415561 37.773101, -122.413161 37.774992))"
68,"Census Tract 179.02, San Francisco County, California",46382,59063,12681,179.02,"MULTIPOLYGON (((-122.332045780727 37.7877603470098, -122.327561619753 37.7806441119025, -122.33227 37.781517, -122.332045780727 37.7877603470098)), ((-122.375979 37.738477, -122.374328 37.73779, -122.373537 37.737176, -122.371996 37.737043, -122.375168 37.736504, -122.374916 37.737453, -122.375137 37.737803, -122.376458 37.738252, -122.375979 37.738477)), ((-122.377679 37.83046, -122.373453 37.832298, -122.368752 37.831286, -122.362911 37.822696, -122.364289 37.81887, -122.358779 37.814278, -122.360775 37.812831, -122.361107 37.808029, -122.362294 37.807016, -122.367138 37.807429, -122.371649 37.809379, -122.372836 37.811068, -122.371269 37.81466899999999, -122.378962 37.826897, -122.377679 37.83046)), ((-122.420365736738 37.86334229717369, -122.419585 37.863282, -122.41847 37.861764, -122.419827349401 37.8600830082779, -122.420365736738 37.86334229717369)))"
69,"Census Tract 180, San Francisco County, California",111375,148698,37323,180.0,"POLYGON ((-122.41248 37.77063, -122.408516 37.77376, -122.40407 37.777273, -122.401843 37.779032, -122.397386 37.782554, -122.39275 37.778852, -122.397206 37.775332, -122.398755 37.776568, -122.400982 37.774809, -122.399433 37.773573, -122.401657 37.771817, -122.404391 37.76974999999999, -122.40499 37.769715, -122.408007 37.769244, -122.409736 37.770349, -122.410931 37.769411, -122.41248 37.77063))"
70,"Census Tract 201, San Francisco County, California",38579,46750,8171,201.0,"POLYGON ((-122.42262 37.772503, -122.422186 37.772909, -122.419334 37.77521, -122.419219 37.775316, -122.417794 37.770435, -122.417802 37.768405, -122.417487 37.765183, -122.417332 37.763572, -122.421732 37.7633, -122.422044 37.76654, -122.422308 37.769278, -122.422365 37.769868, -122.42262 37.772503))"
71,"Census Tract 202, San Francisco County, California",54520,100099,45579,202.0,"POLYGON ((-122.426948 37.769175, -122.426402 37.769596, -122.424929 37.770778, -122.423641 37.771828, -122.42262 37.772503, -122.422365 37.769868, -122.422308 37.769278, -122.422044 37.76654, -122.421732 37.7633, -122.426137 37.763036, -122.426293 37.764651, -122.426462 37.766272, -122.426713 37.768982, -122.426948 37.769175))"
72,"Census Tract 203, San Francisco County, California",100575,140000,39425,203.0,"POLYGON ((-122.435193 37.762727, -122.430824 37.766014, -122.428949 37.767504, -122.428635 37.767846, -122.426948 37.769175, -122.426713 37.768982, -122.426462 37.766272, -122.426293 37.764651, -122.426137 37.763036, -122.430727 37.762753, -122.432124 37.762668, -122.435188 37.762671, -122.435193 37.762727))"
73,"Census Tract 204.01, San Francisco County, California",105263,159412,54149,204.01,"POLYGON ((-122.447915 37.757589, -122.446395 37.758856, -122.446394 37.760907, -122.446783 37.761781, -122.446384 37.761816, -122.444196 37.761947, -122.440168 37.762187, -122.439491 37.762227, -122.439337 37.760627, -122.439167 37.759028, -122.442175 37.758939, -122.442258 37.757734, -122.44222 37.756639, -122.445106 37.756961, -122.444485 37.756354, -122.445283 37.756573, -122.44695 37.75655, -122.447915 37.757589))"
74,"Census Tract 204.02, San Francisco County, California",82066,112818,30752,204.02,"POLYGON ((-122.449447 37.74666, -122.447794 37.749408, -122.445697 37.748855, -122.449423 37.750412, -122.44709 37.751505, -122.446734 37.753573, -122.447943 37.755532, -122.445348 37.755619, -122.44695 37.75655, -122.445283 37.756573, -122.444485 37.756354, -122.445106 37.756961, -122.44222 37.756639, -122.442258 37.757734, -122.442175 37.758939, -122.439167 37.759028, -122.438864 37.755434, -122.440345 37.755228, -122.442525 37.75238, -122.443255 37.750769, -122.443421 37.750099, -122.44462 37.747081, -122.444556 37.746687, -122.444857 37.747025, -122.447399 37.746596, -122.449363 37.746129, -122.45084 37.745904, -122.449447 37.74666))"
75,"Census Tract 205, San Francisco County, California",92473,145263,52790,205.0,"POLYGON ((-122.439491 37.762227, -122.435837 37.762485, -122.435193 37.762727, -122.435188 37.762671, -122.435001 37.760889, -122.434854 37.759289, -122.434698 37.757687, -122.434546 37.756093, -122.437769 37.755541, -122.438864 37.755434, -122.439167 37.759028, -122.439337 37.760627, -122.439491 37.762227))"
76,"Census Tract 206, San Francisco County, California",103229,147213,43984,206.0,"POLYGON ((-122.435188 37.762671, -122.432124 37.762668, -122.430727 37.762753, -122.426137 37.763036, -122.425836 37.759835, -122.425685 37.758232, -122.425532 37.756636, -122.430115 37.75636, -122.432331 37.756227, -122.434546 37.756093, -122.434698 37.757687, -122.434854 37.759289, -122.435001 37.760889, -122.435188 37.762671))"
77,"Census Tract 207, San Francisco County, California",88850,167422,78572,207.0,"POLYGON ((-122.426137 37.763036, -122.421732 37.7633, -122.421578 37.761701, -122.421425 37.760101, -122.421118 37.756902, -122.420964 37.755295, -122.425384 37.755035, -122.425532 37.756636, -122.425685 37.758232, -122.425836 37.759835, -122.426137 37.763036))"
78,"Census Tract 208, San Francisco County, California",56346,103134,46788,208.0,"POLYGON ((-122.421732 37.7633, -122.417332 37.763572, -122.417179 37.761968, -122.417026 37.760367, -122.416872 37.758764, -122.41672 37.757167, -122.416567 37.755568, -122.418748 37.755437, -122.420964 37.755295, -122.421118 37.756902, -122.421425 37.760101, -122.421578 37.761701, -122.421732 37.7633))"
79,"Census Tract 209, San Francisco County, California",47407,106875,59468,209.0,"POLYGON ((-122.420964 37.755295, -122.418748 37.755437, -122.416567 37.755568, -122.416413 37.753968, -122.416108 37.750771, -122.41587 37.748267, -122.418206 37.748203, -122.420282 37.748161, -122.420507 37.750506, -122.420665 37.752104, -122.420812 37.753703, -122.420964 37.755295))"
80,"Census Tract 210, San Francisco County, California",94461,138523,44062,210.0,"POLYGON ((-122.425384 37.755035, -122.420964 37.755295, -122.420812 37.753703, -122.420665 37.752104, -122.420507 37.750506, -122.420282 37.748161, -122.421393 37.748124, -122.42485 37.747825, -122.424777 37.748644, -122.424934 37.750237, -122.425097 37.751845, -122.42524 37.753436, -122.425384 37.755035))"
81,"Census Tract 211, San Francisco County, California",114142,180656,66514,211.0,"POLYGON ((-122.434546 37.756093, -122.432331 37.756227, -122.430115 37.75636, -122.425532 37.756636, -122.425384 37.755035, -122.42524 37.753436, -122.425097 37.751845, -122.429659 37.751571, -122.43409 37.751304, -122.43424 37.752891, -122.434317 37.75369, -122.434546 37.756093))"
82,"Census Tract 212, San Francisco County, California",124444,176845,52401,212.0,"POLYGON ((-122.442525 37.75238, -122.440345 37.755228, -122.438864 37.755434, -122.437769 37.755541, -122.434546 37.756093, -122.434317 37.75369, -122.43424 37.752891, -122.43409 37.751304, -122.438474 37.751024, -122.443255 37.750769, -122.442525 37.75238))"
83,"Census Tract 213, San Francisco County, California",105599,158276,52677,213.0,"POLYGON ((-122.44462 37.747081, -122.443421 37.750099, -122.443255 37.750769, -122.438474 37.751024, -122.43409 37.751304, -122.433769 37.748097, -122.433697 37.747297, -122.435916 37.747179, -122.43809 37.74705, -122.438246 37.748665, -122.441408 37.74861, -122.443961 37.746765, -122.444556 37.746687, -122.44462 37.747081))"
84,"Census Tract 214, San Francisco County, California",101222,165132,63910,214.0,"POLYGON ((-122.43409 37.751304, -122.429659 37.751571, -122.425097 37.751845, -122.424934 37.750237, -122.424777 37.748644, -122.42485 37.747825, -122.427045 37.747696, -122.431477 37.747434, -122.433697 37.747297, -122.433769 37.748097, -122.43409 37.751304))"
85,"Census Tract 215, San Francisco County, California",111712,146638,34926,215.0,"POLYGON ((-122.431477 37.747434, -122.427045 37.747696, -122.42485 37.747825, -122.421393 37.748124, -122.421704 37.746412, -122.422174 37.745614, -122.422709 37.74393999999999, -122.423361 37.74229, -122.430888 37.741833, -122.431022 37.742631, -122.431256 37.74503199999999, -122.431477 37.747434))"
86,"Census Tract 216, San Francisco County, California",90625,143929,53304,216.0,"POLYGON ((-122.447399 37.746596, -122.444857 37.747025, -122.444556 37.746687, -122.443961 37.746765, -122.441408 37.74861, -122.438246 37.748665, -122.43809 37.74705, -122.435916 37.747179, -122.433697 37.747297, -122.431477 37.747434, -122.431256 37.74503199999999, -122.431022 37.742631, -122.430888 37.741833, -122.433259 37.741903, -122.43332 37.743296, -122.435559 37.743161, -122.43556 37.74155, -122.440049 37.745299, -122.444148 37.743297, -122.445214 37.743688, -122.447399 37.746596))"
87,"Census Tract 217, San Francisco County, California",88679,150455,61776,217.0,"POLYGON ((-122.45084 37.745904, -122.449363 37.746129, -122.447399 37.746596, -122.445214 37.743688, -122.444148 37.743297, -122.440049 37.745299, -122.43556 37.74155, -122.435559 37.743161, -122.43332 37.743296, -122.433259 37.741903, -122.430888 37.741833, -122.430741 37.740424, -122.431759 37.73980299999999, -122.428726 37.738326, -122.431349 37.736618, -122.432443 37.735879, -122.434697 37.737256, -122.434401 37.736199, -122.435825 37.733924, -122.438392 37.73442, -122.439915 37.734901, -122.443829 37.736134, -122.443649 37.736519, -122.442489 37.737289, -122.442525 37.739448, -122.445987 37.74118, -122.446658 37.742442, -122.449861 37.743265, -122.451692 37.745629, -122.45084 37.745904))"
88,"Census Tract 218, San Francisco County, California",101315,173372,72057,218.0,"POLYGON ((-122.434401 37.736199, -122.434697 37.737256, -122.432443 37.735879, -122.431349 37.736618, -122.428726 37.738326, -122.431759 37.73980299999999, -122.430741 37.740424, -122.430888 37.741833, -122.423361 37.74229, -122.424258 37.739935, -122.42427 37.739866, -122.424724 37.738431, -122.425286 37.73764, -122.426722 37.736372, -122.428573 37.735082, -122.429391 37.734636, -122.432422 37.733176, -122.433104 37.733419, -122.435825 37.733924, -122.434401 37.736199))"
89,"Census Tract 226, San Francisco County, California",125952,186318,60366,226.0,"POLYGON ((-122.393968 37.766614, -122.388164 37.766958, -122.387917 37.764379, -122.385823 37.767255, -122.380462169293 37.7675163525902, -122.379568 37.76054999999999, -122.380757 37.755288, -122.378560351096 37.7535517721854, -122.380985 37.753228, -122.381711 37.753186, -122.390683 37.752663, -122.391232 37.752657, -122.392447 37.756436, -122.392494 37.760245, -122.392319 37.76106, -122.39252 37.762819, -122.392714 37.764084, -122.393848 37.765307, -122.393968 37.766614))"
90,"Census Tract 227.02, San Francisco County, California",124038,191750,67712,227.02,"POLYGON ((-122.398703 37.765014, -122.393848 37.765307, -122.392714 37.764084, -122.39252 37.762819, -122.392319 37.76106, -122.392494 37.760245, -122.398216 37.759909, -122.398338 37.761184, -122.398461 37.762463, -122.398703 37.765014))"
91,"Census Tract 227.04, San Francisco County, California",135505,185345,49840,227.04,"POLYGON ((-122.40648 37.760731, -122.405105 37.763852, -122.40509 37.76462799999999, -122.404497 37.764664, -122.398703 37.765014, -122.398461 37.762463, -122.398338 37.761184, -122.398216 37.759909, -122.39797 37.757359, -122.403689 37.757015, -122.406389 37.759804, -122.40648 37.760731))"
92,"Census Tract 228.01, San Francisco County, California",77212,117368,40156,228.01,"POLYGON ((-122.417332 37.763572, -122.413588 37.763823, -122.413003 37.764091, -122.408424 37.764427, -122.408064 37.760601, -122.407754 37.757705, -122.412348 37.75743, -122.41672 37.757167, -122.416872 37.758764, -122.417026 37.760367, -122.417179 37.761968, -122.417332 37.763572))"
93,"Census Tract 228.02, San Francisco County, California",88654,102750,14096,228.02,"POLYGON ((-122.408424 37.764427, -122.40509 37.76462799999999, -122.405105 37.763852, -122.40648 37.760731, -122.406389 37.759804, -122.403689 37.757015, -122.403396 37.756471, -122.403127 37.754478, -122.406453 37.75427699999999, -122.407449 37.754506, -122.407602 37.756109, -122.407754 37.757705, -122.408064 37.760601, -122.408424 37.764427))"
94,"Census Tract 228.03, San Francisco County, California",68911,123000,54089,228.03,"POLYGON ((-122.41672 37.757167, -122.412348 37.75743, -122.407754 37.757705, -122.407602 37.756109, -122.407449 37.754506, -122.409253 37.75439799999999, -122.412047 37.75423, -122.416413 37.753968, -122.416567 37.755568, -122.41672 37.757167))"
95,"Census Tract 229.01, San Francisco County, California",50493,91464,40971,229.01,"POLYGON ((-122.416413 37.753968, -122.412047 37.75423, -122.4119 37.752629, -122.411746 37.751034, -122.411488 37.748344, -122.413673 37.748297, -122.41587 37.748267, -122.416108 37.750771, -122.416413 37.753968))"
96,"Census Tract 229.02, San Francisco County, California",70714,133239,62525,229.02,"POLYGON ((-122.412047 37.75423, -122.409253 37.75439799999999, -122.408978 37.751201, -122.40871 37.748397, -122.410551 37.748367, -122.411488 37.748344, -122.411746 37.751034, -122.4119 37.752629, -122.412047 37.75423))"
97,"Census Tract 229.03, San Francisco County, California",67368,128750,61382,229.03,"POLYGON ((-122.409253 37.75439799999999, -122.407449 37.754506, -122.406453 37.75427699999999, -122.403127 37.754478, -122.403007 37.752446, -122.403784 37.749433, -122.405239 37.749125, -122.406788 37.748805, -122.40871 37.748397, -122.408978 37.751201, -122.409253 37.75439799999999))"
98,"Census Tract 230.01, San Francisco County, California",48513,70865,22352,230.01,"POLYGON ((-122.406853 37.73805, -122.399685 37.739902, -122.395945 37.737784, -122.396515 37.737156, -122.398488 37.733808, -122.400022 37.732311, -122.399423 37.731703, -122.399867 37.730292, -122.402105 37.72779, -122.402752 37.729357, -122.404657 37.732949, -122.40506 37.733652, -122.406295 37.735307, -122.406551 37.735721, -122.406853 37.73805))"
99,"Census Tract 230.03, San Francisco County, California",76406,77365,959,230.03,"POLYGON ((-122.400022 37.732311, -122.398488 37.733808, -122.396515 37.737156, -122.392776 37.735038, -122.393904 37.733788, -122.391617 37.732487, -122.391891 37.731684, -122.392699 37.729284, -122.396409 37.72980099999999, -122.399867 37.730292, -122.399423 37.731703, -122.400022 37.732311))"
100,"Census Tract 231.02, San Francisco County, California",26987,31065,4078,231.02,"POLYGON ((-122.387399 37.734738, -122.38717 37.735698, -122.388529 37.736475, -122.385282 37.74024, -122.381558 37.738123, -122.384047 37.737514, -122.382919 37.734511, -122.380186 37.73266, -122.381284 37.734034, -122.379932 37.733381, -122.379779 37.730799, -122.381439 37.730582, -122.38209 37.730635, -122.383431 37.729738, -122.385287 37.730791, -122.389035 37.732919, -122.387399 37.734738))"
101,"Census Tract 231.03, San Francisco County, California",20018,25871,5853,231.03,"POLYGON ((-122.384047 37.737514, -122.381558 37.738123, -122.380887 37.738828, -122.37911 37.73768, -122.376847 37.740192, -122.373364367386 37.7457632793685, -122.36758 37.740214, -122.369101 37.739593, -122.373572 37.739415, -122.373633 37.738854, -122.370762 37.738181, -122.367345 37.738479, -122.367554 37.7381, -122.369648 37.737684, -122.371996 37.737043, -122.373537 37.737176, -122.374328 37.73779, -122.375979 37.738477, -122.376458 37.738252, -122.375137 37.737803, -122.374916 37.737453, -122.375168 37.736504, -122.374715 37.735088, -122.374887291028 37.7342968808983, -122.374982 37.73386199999999, -122.374609 37.73288, -122.373327 37.733186, -122.372024 37.734213, -122.370077 37.732788, -122.369771405992 37.7326989677807, -122.373766 37.728005, -122.378542 37.728942, -122.379697 37.727618, -122.383431 37.729738, -122.38209 37.730635, -122.381439 37.730582, -122.379779 37.730799, -122.379932 37.733381, -122.381284 37.734034, -122.380186 37.73266, -122.382919 37.734511, -122.384047 37.737514))"
102,"Census Tract 232, San Francisco County, California",50156,60345,10189,232.0,"POLYGON ((-122.392699 37.729284, -122.391891 37.731684, -122.391617 37.732487, -122.39106 37.734066, -122.389035 37.732919, -122.385287 37.730791, -122.383431 37.729738, -122.379697 37.727618, -122.377833 37.72656, -122.382176 37.722246, -122.385024 37.724098, -122.386899 37.724289, -122.384517 37.722862, -122.38521 37.723088, -122.38793 37.724729, -122.389801 37.725791, -122.393284 37.727764, -122.392699 37.729284))"
103,"Census Tract 233, San Francisco County, California",66250,58125,-8125,233.0,"POLYGON ((-122.402105 37.72779, -122.399867 37.730292, -122.396409 37.72980099999999, -122.392699 37.729284, -122.393284 37.727764, -122.396682 37.720266, -122.397025 37.719515, -122.398515 37.717664, -122.398863 37.718683, -122.400785 37.723616, -122.401183 37.724588, -122.402105 37.72779))"
104,"Census Tract 234, San Francisco County, California",36544,41724,5180,234.0,"POLYGON ((-122.396682 37.720266, -122.393284 37.727764, -122.389801 37.725791, -122.38793 37.724729, -122.38521 37.723088, -122.384517 37.722862, -122.38282 37.721872, -122.386265 37.717179, -122.38685 37.717509, -122.388131 37.71629799999999, -122.391141 37.71803999999999, -122.393545 37.718487, -122.396682 37.720266))"
105,"Census Tract 251, San Francisco County, California",77893,153021,75128,251.0,"POLYGON ((-122.410662 37.742424, -122.409378 37.742923, -122.410441 37.744918, -122.410619 37.746941, -122.410551 37.748367, -122.40871 37.748397, -122.406788 37.748805, -122.405239 37.749125, -122.403784 37.749433, -122.403569 37.749475, -122.403561 37.747762, -122.40459 37.744126, -122.406952 37.740495, -122.406853 37.73805, -122.408217 37.737612, -122.410377 37.736894, -122.410507 37.739779, -122.410365 37.741362, -122.410662 37.742424))"
106,"Census Tract 252, San Francisco County, California",98815,139444,40629,252.0,"POLYGON ((-122.418206 37.748203, -122.41587 37.748267, -122.413673 37.748297, -122.411488 37.748344, -122.410551 37.748367, -122.410619 37.746941, -122.410441 37.744918, -122.409378 37.742923, -122.410662 37.742424, -122.410365 37.741362, -122.410507 37.739779, -122.411992 37.73971, -122.413938 37.73893, -122.415184 37.738933, -122.415899 37.739002, -122.418584 37.739297, -122.41777 37.740564, -122.418752 37.74118, -122.416103 37.745253, -122.41764 37.745882, -122.417819 37.745965, -122.419121 37.746775, -122.418206 37.748203))"
107,"Census Tract 253, San Francisco County, California",88711,144583,55872,253.0,"POLYGON ((-122.424258 37.739935, -122.423361 37.74229, -122.422709 37.74393999999999, -122.422174 37.745614, -122.421704 37.746412, -122.421393 37.748124, -122.420282 37.748161, -122.418206 37.748203, -122.419121 37.746775, -122.417819 37.745965, -122.41764 37.745882, -122.416103 37.745253, -122.418752 37.74118, -122.41777 37.740564, -122.418584 37.739297, -122.421742 37.740581, -122.422841 37.741027, -122.42427 37.739866, -122.424258 37.739935))"
108,"Census Tract 254.01, San Francisco County, California",79295,122232,42937,254.01,"POLYGON ((-122.425286 37.73764, -122.424724 37.738431, -122.42427 37.739866, -122.422841 37.741027, -122.421742 37.740581, -122.418584 37.739297, -122.415899 37.739002, -122.415955 37.73721099999999, -122.41676 37.735605, -122.420163 37.735777, -122.420224 37.735058, -122.422121 37.735153, -122.422688 37.735205, -122.426722 37.736372, -122.425286 37.73764))"
109,"Census Tract 254.02, San Francisco County, California",99732,129405,29673,254.02,"POLYGON ((-122.41676 37.735605, -122.415955 37.73721099999999, -122.415899 37.739002, -122.415184 37.738933, -122.413938 37.73893, -122.411992 37.73971, -122.410507 37.739779, -122.410377 37.736894, -122.408217 37.737612, -122.408779 37.735817, -122.409798 37.734828, -122.410513 37.734592, -122.412447 37.73467, -122.414313 37.734763, -122.416824 37.734888, -122.41676 37.735605))"
110,"Census Tract 254.03, San Francisco County, California",66500,109118,42618,254.03,"POLYGON ((-122.426722 37.736372, -122.422688 37.735205, -122.422121 37.735153, -122.420224 37.735058, -122.420163 37.735777, -122.41676 37.735605, -122.416824 37.734888, -122.414313 37.734763, -122.412447 37.73467, -122.410513 37.734592, -122.409798 37.734828, -122.414388 37.732417, -122.415939 37.732072, -122.421703 37.731807, -122.423982 37.731552, -122.426104 37.731651, -122.428038 37.732016, -122.426158 37.733971, -122.428573 37.735082, -122.426722 37.736372))"
111,"Census Tract 255, San Francisco County, California",76732,114015,37283,255.0,"POLYGON ((-122.446308 37.725978, -122.443664 37.728304, -122.443075 37.728634, -122.439483 37.730112, -122.439558 37.730191, -122.435892 37.731577, -122.432422 37.733176, -122.429391 37.734636, -122.428573 37.735082, -122.426158 37.733971, -122.428038 37.732016, -122.429304 37.730742, -122.430165 37.729851, -122.430199 37.729872, -122.431294 37.72873, -122.431801 37.728249, -122.432447 37.727637, -122.433982 37.725762, -122.434798 37.724683, -122.435385 37.723909, -122.43702 37.723723, -122.438787 37.723637, -122.444486 37.722974, -122.44473 37.722987, -122.447878 37.723005, -122.446308 37.725978))"
112,"Census Tract 256, San Francisco County, California",63800,85288,21488,256.0,"POLYGON ((-122.431294 37.72873, -122.430199 37.729872, -122.430165 37.729851, -122.429304 37.730742, -122.428038 37.732016, -122.426104 37.731651, -122.423982 37.731552, -122.421703 37.731807, -122.419514 37.73149, -122.419486 37.729046, -122.416637 37.728809, -122.415193 37.729223, -122.41446 37.727457, -122.418404 37.726425, -122.418888 37.72496599999999, -122.419875 37.72471, -122.421847 37.724199, -122.423336 37.727792, -122.424199 37.728736, -122.43039 37.728547, -122.431294 37.72873))"
113,"Census Tract 257.01, San Francisco County, California",79083,98724,19641,257.01,"POLYGON ((-122.421703 37.731807, -122.415939 37.732072, -122.414388 37.732417, -122.409798 37.734828, -122.408779 37.735817, -122.408217 37.737612, -122.406853 37.73805, -122.406551 37.735721, -122.406295 37.735307, -122.405608 37.732439, -122.408509 37.731552, -122.40756 37.729261, -122.410519 37.728488, -122.41446 37.727457, -122.415193 37.729223, -122.416637 37.728809, -122.419486 37.729046, -122.419514 37.73149, -122.421703 37.731807))"
114,"Census Tract 257.02, San Francisco County, California",60500,65875,5375,257.02,"POLYGON ((-122.410519 37.728488, -122.40756 37.729261, -122.408509 37.731552, -122.405608 37.732439, -122.406295 37.735307, -122.40506 37.733652, -122.404657 37.732949, -122.402752 37.729357, -122.402105 37.72779, -122.401183 37.724588, -122.400785 37.723616, -122.402061 37.72392, -122.4026 37.725235, -122.405572 37.724461, -122.408529 37.723688, -122.410519 37.728488))"
115,"Census Tract 258, San Francisco County, California",46250,91250,45000,258.0,"POLYGON ((-122.405572 37.724461, -122.4026 37.725235, -122.402061 37.72392, -122.400785 37.723616, -122.398863 37.718683, -122.399615 37.716278, -122.400435 37.719162, -122.402103 37.718721, -122.403078 37.72113, -122.404059 37.720864, -122.405572 37.724461))"
116,"Census Tract 259, San Francisco County, California",84618,113384,28766,259.0,"POLYGON ((-122.418888 37.72496599999999, -122.418404 37.726425, -122.41446 37.727457, -122.410519 37.728488, -122.408529 37.723688, -122.405572 37.724461, -122.404059 37.720864, -122.403078 37.72113, -122.402103 37.718721, -122.403071 37.71846499999999, -122.4061 37.719837, -122.406665 37.719215, -122.407036 37.720085, -122.41099 37.719074, -122.412468 37.722658, -122.412969 37.723858, -122.416632 37.722157, -122.419875 37.72471, -122.418888 37.72496599999999))"
117,"Census Tract 260.01, San Francisco County, California",72567,74883,2316,260.01,"POLYGON ((-122.435385 37.723909, -122.434798 37.724683, -122.433982 37.725762, -122.432447 37.727637, -122.426912 37.725151, -122.428074 37.723591, -122.428837 37.723955, -122.430026 37.722398, -122.431205 37.720856, -122.432385 37.71929799999999, -122.433985 37.720063, -122.43715 37.721575, -122.435385 37.723909))"
118,"Census Tract 260.02, San Francisco County, California",56875,100000,43125,260.02,"POLYGON ((-122.431801 37.728249, -122.431294 37.72873, -122.43039 37.728547, -122.424199 37.728736, -122.423336 37.727792, -122.421847 37.724199, -122.423807 37.723691, -122.424771 37.722172, -122.428074 37.723591, -122.426912 37.725151, -122.432447 37.727637, -122.431801 37.728249))"
119,"Census Tract 260.03, San Francisco County, California",76108,81071,4963,260.03,"POLYGON ((-122.432385 37.71929799999999, -122.431205 37.720856, -122.430026 37.722398, -122.428837 37.723955, -122.428074 37.723591, -122.424771 37.722172, -122.42583 37.719302, -122.42639 37.718561, -122.427189 37.715748, -122.431154 37.716594, -122.433555 37.717744, -122.432385 37.71929799999999))"
120,"Census Tract 260.04, San Francisco County, California",75057,95655,20598,260.04,"POLYGON ((-122.440141 37.717692, -122.437502 37.721176, -122.43715 37.721575, -122.433985 37.720063, -122.432385 37.71929799999999, -122.433555 37.717744, -122.431154 37.716594, -122.432777 37.714437, -122.437046 37.716008, -122.440418 37.717245, -122.440141 37.717692))"
121,"Census Tract 261, San Francisco County, California",71404,89917,18513,261.0,"POLYGON ((-122.448582 37.718411, -122.447878 37.723005, -122.44473 37.722987, -122.444486 37.722974, -122.438787 37.723637, -122.43702 37.723723, -122.435385 37.723909, -122.43715 37.721575, -122.437502 37.721176, -122.440141 37.717692, -122.440418 37.717245, -122.440999 37.716488, -122.441896 37.715308, -122.443706 37.713592, -122.446945 37.716187, -122.44796 37.717, -122.448727 37.71745, -122.448582 37.718411))"
122,"Census Tract 262, San Francisco County, California",87156,77928,-9228,262.0,"POLYGON ((-122.465994 37.710154, -122.460858 37.710586, -122.457312 37.710648, -122.456376 37.710825, -122.455619 37.711066, -122.455028 37.711317, -122.452884 37.712829, -122.449627 37.715739, -122.448727 37.71745, -122.44796 37.717, -122.446945 37.716187, -122.443706 37.713592, -122.444571 37.712783, -122.446091 37.711592, -122.449309 37.709946, -122.452665 37.708806, -122.453983 37.708232, -122.458509 37.708231, -122.45905 37.708231, -122.468939 37.708232, -122.465994 37.710154))"
123,"Census Tract 263.01, San Francisco County, California",63175,70345,7170,263.01,"POLYGON ((-122.444571 37.712783, -122.443706 37.713592, -122.441896 37.715308, -122.440999 37.716488, -122.440418 37.717245, -122.437046 37.716008, -122.432777 37.714437, -122.433682 37.713181, -122.436144 37.714254, -122.436203 37.714171, -122.436642 37.71355, -122.437811 37.71192, -122.443335 37.710555, -122.444097 37.711689, -122.444571 37.712783))"
124,"Census Tract 263.02, San Francisco County, California",57813,84457,26644,263.02,"POLYGON ((-122.437811 37.71192, -122.436642 37.71355, -122.436203 37.714171, -122.436144 37.714254, -122.433682 37.713181, -122.432777 37.714437, -122.431154 37.716594, -122.427189 37.715748, -122.425548 37.714517, -122.426737 37.711225, -122.424478 37.71011, -122.423377 37.709203, -122.42389 37.708236, -122.428082 37.708431, -122.430027 37.708281, -122.431341 37.708231, -122.433382 37.708232, -122.433982 37.708132, -122.435382 37.708132, -122.436771 37.710156, -122.436993 37.710746, -122.43837 37.711133, -122.437811 37.71192))"
125,"Census Tract 263.03, San Francisco County, California",91698,92992,1294,263.03,"POLYGON ((-122.452665 37.708806, -122.449309 37.709946, -122.446091 37.711592, -122.444571 37.712783, -122.444097 37.711689, -122.443335 37.710555, -122.437811 37.71192, -122.43837 37.711133, -122.436993 37.710746, -122.436771 37.710156, -122.435382 37.708132, -122.440781 37.708304, -122.442079 37.708231, -122.444482 37.708332, -122.445875 37.708233, -122.449751 37.708213, -122.4523 37.708138, -122.45247 37.708148, -122.453983 37.708232, -122.452665 37.708806))"
126,"Census Tract 264.01, San Francisco County, California",49000,75156,26156,264.01,"POLYGON ((-122.415635 37.712733, -122.415291 37.713504, -122.415396 37.715474, -122.411316 37.714367, -122.410433 37.716414, -122.406189 37.715244, -122.407927 37.711448, -122.410641 37.71220599999999, -122.411349 37.710605, -122.412887 37.711036, -122.416 37.711915, -122.415635 37.712733))"
127,"Census Tract 264.02, San Francisco County, California",59625,82010,22385,264.02,"POLYGON ((-122.40895 37.716458, -122.408255 37.71809, -122.407272 37.71782, -122.406665 37.719215, -122.4061 37.719837, -122.403071 37.71846499999999, -122.402103 37.718721, -122.400435 37.719162, -122.399615 37.716278, -122.398863 37.718683, -122.398515 37.717664, -122.398328 37.716259, -122.400626 37.712984, -122.402546 37.712266, -122.402154 37.712656, -122.402188 37.714731, -122.403617 37.714327, -122.406189 37.715244, -122.410433 37.716414, -122.40895 37.716458))"
128,"Census Tract 264.03, San Francisco County, California",48125,75455,27330,264.03,"POLYGON ((-122.411349 37.710605, -122.410641 37.71220599999999, -122.407927 37.711448, -122.406189 37.715244, -122.403617 37.714327, -122.402188 37.714731, -122.402154 37.712656, -122.402546 37.712266, -122.403109 37.711998, -122.404348 37.710443, -122.404821 37.709747, -122.405582 37.708231, -122.406481 37.708323, -122.41238 37.708303, -122.411349 37.710605))"
129,"Census Tract 264.04, San Francisco County, California",44128,54805,10677,264.04,"POLYGON ((-122.420083 37.70831099999999, -122.419348 37.709947, -122.416648 37.710473, -122.416 37.711915, -122.412887 37.711036, -122.411349 37.710605, -122.41238 37.708303, -122.415182 37.708231, -122.416222 37.708328, -122.420082 37.708231, -122.420083 37.70831099999999))"
130,"Census Tract 301.01, San Francisco County, California",92000,122264,30264,301.01,"POLYGON ((-122.464297 37.765963, -122.46109 37.766132, -122.458405 37.76616, -122.45779 37.766015, -122.456913 37.765874, -122.452947 37.766374, -122.452758 37.765443, -122.452569 37.764509, -122.455466 37.764161, -122.457536 37.763566, -122.460843 37.762628, -122.462972 37.762316, -122.463226 37.758562, -122.463782 37.758538, -122.463912 37.760405, -122.464042 37.762269, -122.464172 37.764131, -122.464297 37.765963))"
131,"Census Tract 301.02, San Francisco County, California",91827,147549,55722,301.02,"POLYGON ((-122.463782 37.758538, -122.463226 37.758562, -122.462972 37.762316, -122.460843 37.762628, -122.457536 37.763566, -122.455466 37.764161, -122.452569 37.764509, -122.4524 37.763669, -122.451958 37.761478, -122.44912 37.761648, -122.446783 37.761781, -122.446394 37.760907, -122.446395 37.758856, -122.447915 37.757589, -122.448535 37.759045, -122.451367 37.758576, -122.453872 37.757378, -122.454078 37.757027, -122.454172 37.756507, -122.455537 37.753774, -122.456091 37.751804, -122.46147 37.751522, -122.462108 37.75197199999999, -122.463361 37.753039, -122.46377 37.754142, -122.463658 37.756764, -122.463782 37.758538))"
132,"Census Tract 302.01, San Francisco County, California",69267,111000,41733,302.01,"POLYGON ((-122.477261 37.765486, -122.47073 37.76577899999999, -122.470595 37.763849, -122.470468 37.762027, -122.470335 37.760124, -122.476762 37.759837, -122.476974 37.761701, -122.477116 37.763562, -122.477261 37.765486))"
133,"Census Tract 302.02, San Francisco County, California",83077,123139,40062,302.02,"POLYGON ((-122.47073 37.76577899999999, -122.464297 37.765963, -122.464172 37.764131, -122.464042 37.762269, -122.463912 37.760405, -122.469263 37.760171, -122.470335 37.760124, -122.470468 37.762027, -122.470595 37.763849, -122.47073 37.76577899999999))"
134,"Census Tract 303.01, San Francisco County, California",92207,141125,48918,303.01,"POLYGON ((-122.476762 37.759837, -122.470335 37.760124, -122.469263 37.760171, -122.463912 37.760405, -122.463782 37.758538, -122.463658 37.756764, -122.46377 37.754142, -122.463361 37.753039, -122.463433 37.753028, -122.464462 37.752899, -122.4666 37.752803, -122.468335 37.753244, -122.469782 37.752675, -122.47068 37.752376, -122.470908 37.752616, -122.47121 37.755194, -122.473683 37.756237, -122.4766 37.756108, -122.476699 37.757968, -122.47687 37.759832, -122.476762 37.759837))"
135,"Census Tract 303.02, San Francisco County, California",110673,138125,27452,303.02,"POLYGON ((-122.4766 37.756108, -122.473683 37.756237, -122.47121 37.755194, -122.470908 37.752616, -122.47068 37.752376, -122.469782 37.752675, -122.468335 37.753244, -122.4666 37.752803, -122.464462 37.752899, -122.463442 37.751195, -122.464186 37.750717, -122.465403 37.750986, -122.466469 37.750939, -122.466336 37.749075, -122.469549 37.748903, -122.470595 37.748869, -122.476131 37.748643, -122.476221 37.750509, -122.476355 37.752376, -122.4766 37.756108))"
136,"Census Tract 304, San Francisco County, California",126818,160733,33915,304.0,"POLYGON ((-122.476131 37.748643, -122.470595 37.748869, -122.469549 37.748903, -122.466336 37.749075, -122.466469 37.750939, -122.465403 37.750986, -122.464186 37.750717, -122.463442 37.751195, -122.464462 37.752899, -122.463433 37.753028, -122.463361 37.753039, -122.462108 37.75197199999999, -122.46147 37.751522, -122.458635 37.747769, -122.459174 37.747286, -122.461381 37.745569, -122.463686 37.743749, -122.465807 37.743574, -122.466043 37.743555, -122.470235 37.743289, -122.475726 37.743049, -122.475854 37.744915, -122.476007 37.746778, -122.476131 37.748643))"
137,"Census Tract 305, San Francisco County, California",106007,143558,37551,305.0,"POLYGON ((-122.46147 37.751522, -122.456091 37.751804, -122.455537 37.753774, -122.454172 37.756507, -122.454078 37.757027, -122.453872 37.757378, -122.451367 37.758576, -122.448535 37.759045, -122.447915 37.757589, -122.44695 37.75655, -122.445348 37.755619, -122.447943 37.755532, -122.446734 37.753573, -122.44709 37.751505, -122.449423 37.750412, -122.445697 37.748855, -122.447794 37.749408, -122.449447 37.74666, -122.45084 37.745904, -122.451692 37.745629, -122.453897 37.745742, -122.454275 37.745908, -122.454637 37.746142, -122.458743 37.746876, -122.459174 37.747286, -122.458635 37.747769, -122.46147 37.751522))"
138,"Census Tract 306, San Francisco County, California",138056,172500,34444,306.0,"POLYGON ((-122.461381 37.745569, -122.459174 37.747286, -122.458743 37.746876, -122.454637 37.746142, -122.454275 37.745908, -122.453897 37.745742, -122.451692 37.745629, -122.449861 37.743265, -122.452306 37.742819, -122.453773 37.743219, -122.454238 37.742835, -122.45464 37.742326, -122.454932 37.741777, -122.458082 37.739099, -122.458849 37.739158, -122.459184 37.739871, -122.459386 37.740571, -122.45984 37.74106099999999, -122.461234 37.742584, -122.463686 37.743749, -122.461381 37.745569))"
139,"Census Tract 307, San Francisco County, California",128203,146618,18415,307.0,"POLYGON ((-122.459592 37.738533, -122.458849 37.739158, -122.458082 37.739099, -122.454932 37.741777, -122.45464 37.742326, -122.454238 37.742835, -122.453773 37.743219, -122.452306 37.742819, -122.449861 37.743265, -122.446658 37.742442, -122.445987 37.74118, -122.442525 37.739448, -122.442489 37.737289, -122.443649 37.736519, -122.443829 37.736134, -122.439915 37.734901, -122.438392 37.73442, -122.438816 37.733087, -122.439752 37.733111, -122.448873 37.733069, -122.453425 37.73304, -122.456156 37.734212, -122.459505 37.734291, -122.460282 37.737855, -122.459592 37.738533))"
140,"Census Tract 308, San Francisco County, California",122139,152351,30212,308.0,"POLYGON ((-122.475726 37.743049, -122.470235 37.743289, -122.466043 37.743555, -122.465807 37.743574, -122.463686 37.743749, -122.461234 37.742584, -122.45984 37.74106099999999, -122.459386 37.740571, -122.459184 37.739871, -122.458849 37.739158, -122.459592 37.738533, -122.460282 37.737855, -122.459505 37.734291, -122.461242 37.735782, -122.463136 37.737023, -122.462913 37.736013, -122.466248 37.734937, -122.471569 37.734707, -122.475173 37.734562, -122.475189 37.734762, -122.47539 37.73745, -122.475485 37.739321, -122.475621 37.741183, -122.475726 37.743049))"
141,"Census Tract 309, San Francisco County, California",144900,171595,26695,309.0,"POLYGON ((-122.475347 37.720914, -122.474745 37.72693599999999, -122.474634 37.728992, -122.474972 37.731072, -122.475173 37.734562, -122.471569 37.734707, -122.466248 37.734937, -122.462913 37.736013, -122.463136 37.737023, -122.461242 37.735782, -122.459505 37.734291, -122.459064 37.733645, -122.461748 37.730064, -122.461727 37.729993, -122.460816 37.728681, -122.462888 37.728056, -122.462786 37.725549, -122.462199 37.725293, -122.462265 37.721748, -122.466278 37.721668, -122.46974 37.721644, -122.471983 37.721661, -122.47244 37.721603, -122.472547 37.71964, -122.472672 37.717248, -122.474528 37.719065, -122.475368 37.72037, -122.475347 37.720914))"
142,"Census Tract 310, San Francisco County, California",91907,153456,61549,310.0,"POLYGON ((-122.462888 37.728056, -122.460816 37.728681, -122.461727 37.729993, -122.461748 37.730064, -122.459064 37.733645, -122.459505 37.734291, -122.456156 37.734212, -122.453425 37.73304, -122.453411 37.731568, -122.453394 37.729837, -122.454002 37.729166, -122.452382 37.727868, -122.452335 37.72318, -122.453105 37.723206, -122.458191 37.72434399999999, -122.459213 37.724563, -122.461202 37.724974, -122.462199 37.725293, -122.462786 37.725549, -122.462888 37.728056))"
143,"Census Tract 311, San Francisco County, California",101641,127011,25370,311.0,"POLYGON ((-122.453394 37.729837, -122.453411 37.731568, -122.453425 37.73304, -122.448873 37.733069, -122.439752 37.733111, -122.438816 37.733087, -122.438392 37.73442, -122.435825 37.733924, -122.433104 37.733419, -122.432422 37.733176, -122.435892 37.731577, -122.439558 37.730191, -122.439483 37.730112, -122.443075 37.728634, -122.443664 37.728304, -122.446308 37.725978, -122.447878 37.723005, -122.449546 37.723011, -122.451596 37.723033, -122.452335 37.72318, -122.452382 37.727868, -122.454002 37.729166, -122.453394 37.729837))"
144,"Census Tract 312.01, San Francisco County, California",65732,83381,17649,312.01,"POLYGON ((-122.462265 37.721748, -122.462199 37.725293, -122.461202 37.724974, -122.459213 37.724563, -122.458191 37.72434399999999, -122.453105 37.723206, -122.452335 37.72318, -122.451596 37.723033, -122.449546 37.723011, -122.451646 37.719686, -122.452506 37.72003, -122.459198 37.720024, -122.459187 37.71823, -122.462245 37.71822, -122.462265 37.721748))"
145,"Census Tract 312.02, San Francisco County, California",67271,79712,12441,312.02,"POLYGON ((-122.459198 37.720024, -122.452506 37.72003, -122.451646 37.719686, -122.449546 37.723011, -122.447878 37.723005, -122.448582 37.718411, -122.450378 37.716169, -122.451895 37.716978, -122.453378 37.717768, -122.454189 37.718239, -122.456108 37.718235, -122.459187 37.71823, -122.459198 37.720024))"
146,"Census Tract 313.01, San Francisco County, California",72682,101116,28434,313.01,"POLYGON ((-122.472547 37.71964, -122.47244 37.721603, -122.471983 37.721661, -122.46974 37.721644, -122.466278 37.721668, -122.462265 37.721748, -122.462245 37.71822, -122.46264 37.717936, -122.466235 37.717912, -122.468036 37.7179, -122.468017 37.716103, -122.471572 37.716126, -122.472672 37.717248, -122.472547 37.71964))"
147,"Census Tract 313.02, San Francisco County, California",82901,77260,-5641,313.02,"POLYGON ((-122.471572 37.716126, -122.468017 37.716103, -122.468036 37.7179, -122.466235 37.717912, -122.46264 37.717936, -122.462615 37.715619, -122.462602 37.714308, -122.462569 37.71315, -122.462556 37.711254, -122.460858 37.710586, -122.465994 37.710154, -122.468939 37.708232, -122.469236 37.708232, -122.471319 37.708305, -122.471215 37.708939, -122.471355 37.712802, -122.471472 37.713427, -122.472672 37.717248, -122.471572 37.716126))"
148,"Census Tract 314, San Francisco County, California",55079,73750,18671,314.0,"POLYGON ((-122.46264 37.717936, -122.462245 37.71822, -122.459187 37.71823, -122.456108 37.718235, -122.454189 37.718239, -122.453378 37.717768, -122.451895 37.716978, -122.450378 37.716169, -122.448582 37.718411, -122.448727 37.71745, -122.449627 37.715739, -122.452884 37.712829, -122.455028 37.711317, -122.455619 37.711066, -122.456376 37.710825, -122.457312 37.710648, -122.460858 37.710586, -122.462556 37.711254, -122.462569 37.71315, -122.462602 37.714308, -122.462615 37.715619, -122.46264 37.717936))"
149,"Census Tract 326.01, San Francisco County, California",61224,116128,54904,326.01,"POLYGON ((-122.484763 37.76516, -122.477261 37.765486, -122.477116 37.763562, -122.476974 37.761701, -122.476762 37.759837, -122.47687 37.759832, -122.484365 37.759501, -122.484496 37.76137, -122.484627 37.763231, -122.484763 37.76516))"
150,"Census Tract 326.02, San Francisco County, California",58494,96932,38438,326.02,"POLYGON ((-122.486906 37.765054, -122.484763 37.76516, -122.484627 37.763231, -122.484496 37.76137, -122.484365 37.759501, -122.47687 37.759832, -122.476699 37.757968, -122.4766 37.756108, -122.479817 37.755966, -122.484104 37.75577699999999, -122.486248 37.755683, -122.486382 37.757542, -122.486512 37.759407, -122.48664 37.761276, -122.48677 37.763137, -122.486906 37.765054))"
151,"Census Tract 327, San Francisco County, California",85446,115457,30011,327.0,"POLYGON ((-122.496085 37.764675, -122.493336 37.764774, -122.486906 37.765054, -122.48677 37.763137, -122.48664 37.761276, -122.486512 37.759407, -122.486382 37.757542, -122.486248 37.755683, -122.492675 37.755398, -122.495433 37.755273, -122.495555 37.757137, -122.495692 37.759001, -122.495822 37.760871, -122.49595 37.762732, -122.496085 37.764675))"
152,"Census Tract 328.01, San Francisco County, California",92778,114290,21512,328.01,"POLYGON ((-122.485727 37.74822, -122.479296 37.748504, -122.479426 37.750368, -122.476221 37.750509, -122.476131 37.748643, -122.476007 37.746778, -122.475854 37.744915, -122.475726 37.743049, -122.485335 37.742626, -122.485466 37.744493, -122.485597 37.746354, -122.485727 37.74822))"
153,"Census Tract 328.02, San Francisco County, California",59792,103861,44069,328.02,"POLYGON ((-122.486248 37.755683, -122.484104 37.75577699999999, -122.479817 37.755966, -122.4766 37.756108, -122.476355 37.752376, -122.476221 37.750509, -122.479426 37.750368, -122.479296 37.748504, -122.485727 37.74822, -122.485857 37.750085, -122.485988 37.751951, -122.486118 37.753815, -122.486248 37.755683))"
154,"Census Tract 329.01, San Francisco County, California",92706,112500,19794,329.01,"POLYGON ((-122.495046 37.749681, -122.485857 37.750085, -122.485727 37.74822, -122.485597 37.746354, -122.485466 37.744493, -122.485335 37.742626, -122.494504 37.742222, -122.494646 37.744089, -122.494774 37.745949, -122.494911 37.747814, -122.495046 37.749681))"
155,"Census Tract 329.02, San Francisco County, California",77037,94545,17508,329.02,"POLYGON ((-122.495433 37.755273, -122.492675 37.755398, -122.486248 37.755683, -122.486118 37.753815, -122.485988 37.751951, -122.485857 37.750085, -122.495046 37.749681, -122.495165 37.751543, -122.495307 37.75341, -122.495433 37.755273))"
156,"Census Tract 330, San Francisco County, California",110486,100907,-9579,330.0,"POLYGON ((-122.494504 37.742222, -122.485335 37.742626, -122.475726 37.743049, -122.475621 37.741183, -122.475485 37.739321, -122.47539 37.73745, -122.475189 37.734762, -122.479547 37.734619, -122.480254 37.73459, -122.485518 37.734356, -122.485855 37.734182, -122.491294 37.734096, -122.493784 37.733989, -122.494126 37.736631, -122.494253 37.738493, -122.494404 37.740352, -122.494504 37.742222))"
157,"Census Tract 331, San Francisco County, California",103589,114783,11194,331.0,"POLYGON ((-122.499059 37.731576, -122.496564 37.733856, -122.493784 37.733989, -122.491294 37.734096, -122.485855 37.734182, -122.485518 37.734356, -122.480254 37.73459, -122.479547 37.734619, -122.475189 37.734762, -122.475173 37.734562, -122.474972 37.731072, -122.480015 37.731148, -122.48193 37.731172, -122.485302 37.730946, -122.486179 37.730879, -122.486606 37.729555, -122.48889 37.730257, -122.492161 37.728836, -122.493529 37.729594, -122.497017 37.729303, -122.499059 37.731576))"
158,"Census Tract 332.01, San Francisco County, California",41250,34706,-6544,332.01,"POLYGON ((-122.486179 37.730879, -122.485302 37.730946, -122.48193 37.731172, -122.480015 37.731148, -122.474972 37.731072, -122.474634 37.728992, -122.474745 37.72693599999999, -122.475347 37.720914, -122.478988 37.720844, -122.479631 37.719663, -122.484909 37.724032, -122.483811 37.727029, -122.486606 37.729555, -122.486179 37.730879))"
159,"Census Tract 332.03, San Francisco County, California",59875,47188,-12687,332.03,"POLYGON ((-122.485124 37.718575, -122.484832 37.718571, -122.483143 37.718517, -122.483205 37.717585, -122.479981 37.716942, -122.478674 37.717903, -122.47724 37.717709, -122.475818 37.716891, -122.474383 37.717507, -122.474528 37.719065, -122.472672 37.717248, -122.471472 37.713427, -122.471355 37.712802, -122.476624 37.714567, -122.485043 37.714754, -122.485124 37.718575))"
160,"Census Tract 332.04, San Francisco County, California",46190,62701,16511,332.04,"POLYGON ((-122.484909 37.724032, -122.479631 37.719663, -122.478988 37.720844, -122.475347 37.720914, -122.475368 37.72037, -122.474528 37.719065, -122.474383 37.717507, -122.475818 37.716891, -122.47724 37.717709, -122.478674 37.717903, -122.479981 37.716942, -122.483205 37.717585, -122.483143 37.718517, -122.484832 37.718571, -122.485124 37.718575, -122.484909 37.724032))"
161,"Census Tract 351, San Francisco County, California",90114,121156,31042,351.0,"POLYGON ((-122.502979 37.764344, -122.496085 37.764675, -122.49595 37.762732, -122.495822 37.760871, -122.495692 37.759001, -122.495555 37.757137, -122.495433 37.755273, -122.495307 37.75341, -122.495165 37.751543, -122.499914 37.751334, -122.499784 37.749472, -122.50193 37.749377, -122.50206 37.75124, -122.502191 37.753106, -122.502318 37.754953, -122.50245 37.756835, -122.502582 37.7587, -122.502713 37.760567, -122.502844 37.762427, -122.502979 37.764344))"
162,"Census Tract 352.01, San Francisco County, California",62350,102652,40302,352.01,"POLYGON ((-122.512070759187 37.7636593024008, -122.50987 37.76409, -122.509622 37.762127, -122.509382 37.760272, -122.509111 37.75841399999999, -122.502582 37.7587, -122.50245 37.756835, -122.502318 37.754953, -122.502191 37.753106, -122.50206 37.75124, -122.50193 37.749377, -122.505148 37.749235, -122.507942 37.749111, -122.509993368973 37.74881495033259, -122.512070759187 37.7636593024008))"
163,"Census Tract 352.02, San Francisco County, California",66958,82593,15635,352.02,"POLYGON ((-122.50987 37.76409, -122.502979 37.764344, -122.502844 37.762427, -122.502713 37.760567, -122.502582 37.7587, -122.509111 37.75841399999999, -122.509382 37.760272, -122.509622 37.762127, -122.50987 37.76409))"
164,"Census Tract 353, San Francisco County, California",77936,93375,15439,353.0,"POLYGON ((-122.50193 37.749377, -122.499784 37.749472, -122.499914 37.751334, -122.495165 37.751543, -122.495046 37.749681, -122.494911 37.747814, -122.494774 37.745949, -122.494646 37.744089, -122.494504 37.742222, -122.494404 37.740352, -122.494253 37.738493, -122.494126 37.736631, -122.493784 37.733989, -122.496564 37.733856, -122.497487 37.733925, -122.499139 37.734404, -122.501041 37.7353, -122.501142 37.738192, -122.501404 37.74191, -122.501536 37.743785, -122.50193 37.749377))"
165,"Census Tract 354, San Francisco County, California",75100,102500,27400,354.0,"POLYGON ((-122.509993368973 37.74881495033259, -122.507942 37.749111, -122.505148 37.749235, -122.50193 37.749377, -122.501536 37.743785, -122.501404 37.74191, -122.501142 37.738192, -122.501041 37.7353, -122.502031 37.735515, -122.505262 37.735565, -122.506796 37.73555899999999, -122.508121548602 37.7354395332202, -122.509993368973 37.74881495033259))"
166,"Census Tract 401, San Francisco County, California",56812,94589,37777,401.0,"POLYGON ((-122.464781 37.788564, -122.463581 37.788806, -122.459476 37.789711, -122.459388 37.788405, -122.459179 37.785682, -122.458998 37.783189, -122.458878 37.781326, -122.461068 37.781227, -122.464284 37.781089, -122.464551 37.784792, -122.464781 37.788564))"
167,"Census Tract 402, San Francisco County, California",69564,105507,35943,402.0,"POLYGON ((-122.472583 37.786317, -122.472352 37.787234, -122.470912 37.787221, -122.466924 37.788132, -122.464781 37.788564, -122.464551 37.784792, -122.464284 37.781089, -122.466432 37.78099, -122.467492 37.780938, -122.472264 37.780747, -122.472379 37.782581, -122.472516 37.784453, -122.472583 37.786317))"
168,"Census Tract 426.01, San Francisco County, California",65107,84805,19698,426.01,"POLYGON ((-122.48408 37.785795, -122.478714 37.786031, -122.478579 37.784174, -122.478444 37.782308, -122.47831 37.780449, -122.479388 37.780403, -122.482598 37.780265, -122.483667 37.780207, -122.483804 37.782077, -122.483936 37.783931, -122.48408 37.785795))"
169,"Census Tract 426.02, San Francisco County, California",72819,128375,55556,426.02,"POLYGON ((-122.478714 37.786031, -122.472583 37.786317, -122.472516 37.784453, -122.472379 37.782581, -122.472264 37.780747, -122.47831 37.780449, -122.478444 37.782308, -122.478579 37.784174, -122.478714 37.786031))"
170,"Census Tract 427, San Francisco County, California",78059,76118,-1941,427.0,"POLYGON ((-122.493491 37.783498, -122.490364 37.78364, -122.487151 37.783785, -122.487286 37.785649, -122.48408 37.785795, -122.483936 37.783931, -122.483804 37.782077, -122.483667 37.780207, -122.489019 37.779977, -122.491172 37.779869, -122.493305 37.77975199999999, -122.493446 37.781627, -122.493491 37.783498))"
171,"Census Tract 428, San Francisco County, California",154063,164750,10687,428.0,"POLYGON ((-122.493338 37.787403, -122.493048716406 37.7879341073778, -122.492883 37.787929, -122.485827333182 37.7906121409026, -122.483985 37.789769, -122.483799 37.78774, -122.479845 37.786796, -122.472352 37.787234, -122.472583 37.786317, -122.478714 37.786031, -122.48408 37.785795, -122.487286 37.785649, -122.487151 37.783785, -122.490364 37.78364, -122.493491 37.783498, -122.493338 37.787403))"
172,"Census Tract 451, San Francisco County, California",73750,116429,42679,451.0,"POLYGON ((-122.464284 37.781089, -122.461068 37.781227, -122.458878 37.781326, -122.458505 37.77619, -122.458371 37.774309, -122.460553 37.774031, -122.463749 37.773624, -122.464011 37.777235, -122.464284 37.781089))"
173,"Census Tract 452, San Francisco County, California",61781,98864,37083,452.0,"POLYGON ((-122.472264 37.780747, -122.467492 37.780938, -122.466432 37.78099, -122.464284 37.781089, -122.464011 37.777235, -122.463749 37.773624, -122.465332 37.773423, -122.466952 37.773351, -122.471706 37.773141, -122.471842 37.775006, -122.471967 37.776871, -122.472103 37.778731, -122.472264 37.780747))"
174,"Census Tract 476, San Francisco County, California",65682,103676,37994,476.0,"POLYGON ((-122.479388 37.780403, -122.47831 37.780449, -122.472264 37.780747, -122.472103 37.778731, -122.471967 37.776871, -122.471842 37.775006, -122.471706 37.773141, -122.478837 37.772815, -122.478972 37.774681, -122.479106 37.776546, -122.479241 37.778408, -122.479388 37.780403))"
175,"Census Tract 477.01, San Francisco County, California",61647,86848,25201,477.01,"POLYGON ((-122.489019 37.779977, -122.483667 37.780207, -122.482598 37.780265, -122.479388 37.780403, -122.479241 37.778408, -122.479106 37.776546, -122.482318 37.7764, -122.488741 37.776107, -122.488876 37.777972, -122.489019 37.779977))"
176,"Census Tract 477.02, San Francisco County, California",86894,98958,12064,477.02,"POLYGON ((-122.488741 37.776107, -122.482318 37.7764, -122.479106 37.776546, -122.478972 37.774681, -122.478837 37.772815, -122.482049 37.772667, -122.488471 37.772374, -122.488606 37.774241, -122.488741 37.776107))"
177,"Census Tract 478.01, San Francisco County, California",78056,108525,30469,478.01,"POLYGON ((-122.497455 37.777579, -122.493168 37.777774, -122.493305 37.77975199999999, -122.491172 37.779869, -122.489019 37.779977, -122.488876 37.777972, -122.488741 37.776107, -122.488606 37.774241, -122.488471 37.772374, -122.494903 37.772081, -122.495039 37.773947, -122.495175 37.775813, -122.497319 37.775715, -122.497455 37.777579))"
178,"Census Tract 478.02, San Francisco County, California",86563,91250,4687,478.02,"POLYGON ((-122.498801 37.781377, -122.493446 37.781627, -122.493305 37.77975199999999, -122.493168 37.777774, -122.497455 37.777579, -122.497319 37.775715, -122.495175 37.775813, -122.495039 37.773947, -122.494903 37.772081, -122.498114 37.771934, -122.49825 37.7738, -122.498386 37.775667, -122.498521 37.777531, -122.498669 37.779507, -122.498801 37.781377))"
179,"Census Tract 479.01, San Francisco County, California",78643,99750,21107,479.01,"POLYGON ((-122.514483 37.780829, -122.509842514521 37.7846145393916, -122.507484 37.782185, -122.510781 37.782059, -122.509879 37.780627, -122.509593 37.780173, -122.509228 37.777044, -122.506022 37.77719, -122.501733 37.777385, -122.498521 37.777531, -122.498386 37.775667, -122.49825 37.7738, -122.498114 37.771934, -122.505611 37.771592, -122.511124 37.771323, -122.513067688424 37.7707830331714, -122.513128 37.771214, -122.514483 37.780829))"
180,"Census Tract 479.02, San Francisco County, California",88158,94688,6530,479.02,"POLYGON ((-122.509879 37.780627, -122.506509 37.780857, -122.505226 37.781077, -122.502012 37.781227, -122.498801 37.781377, -122.498669 37.779507, -122.498521 37.777531, -122.501733 37.777385, -122.506022 37.77719, -122.509228 37.777044, -122.509593 37.780173, -122.509879 37.780627))"
181,"Census Tract 601, San Francisco County, California",117500,184934,67434,601.0,"POLYGON ((-122.485783 37.790629, -122.480296 37.801293, -122.478083 37.810828, -122.470336 37.808671, -122.463793 37.804653, -122.448241130218 37.8072521685356, -122.449179 37.802074, -122.44782 37.801633, -122.447466 37.79939, -122.447303 37.798459, -122.447015 37.796579, -122.446728 37.794706, -122.4463 37.791879, -122.45274 37.790974, -122.459476 37.789711, -122.463581 37.788806, -122.464781 37.788564, -122.466924 37.788132, -122.470912 37.787221, -122.472352 37.787234, -122.479845 37.786796, -122.483799 37.78774, -122.483985 37.789769, -122.485827333182 37.7906121409026, -122.485783 37.790629))"
182,"Census Tract 604, San Francisco County, California",62245,64153,1908,604.0,"POLYGON ((-122.506796 37.73555899999999, -122.505262 37.735565, -122.502031 37.735515, -122.501041 37.7353, -122.499139 37.734404, -122.497487 37.733925, -122.496564 37.733856, -122.499059 37.731576, -122.497017 37.729303, -122.493529 37.729594, -122.492161 37.728836, -122.48889 37.730257, -122.486606 37.729555, -122.483811 37.727029, -122.484909 37.724032, -122.485124 37.718575, -122.485043 37.714754, -122.476624 37.714567, -122.471355 37.712802, -122.471215 37.708939, -122.471319 37.708305, -122.486042 37.708233, -122.502426880724 37.7081329861058, -122.506483 37.723731, -122.508121548602 37.7354395332202, -122.506796 37.73555899999999))"
183,"Census Tract 605.02, San Francisco County, California",23333,26350,3017,605.02,"POLYGON ((-122.424478 37.71011, -122.423027 37.710377, -122.422241 37.711317, -122.421475 37.712201, -122.420908 37.713774, -122.415635 37.712733, -122.416 37.711915, -122.416648 37.710473, -122.419348 37.709947, -122.420083 37.70831099999999, -122.420082 37.708231, -122.42389 37.708236, -122.423377 37.709203, -122.424478 37.71011))"
184,"Census Tract 607, San Francisco County, California",104545,158667,54122,607.0,"POLYGON ((-122.40499 37.769715, -122.404391 37.76974999999999, -122.401657 37.771817, -122.399433 37.773573, -122.400982 37.774809, -122.398755 37.776568, -122.397206 37.775332, -122.39275 37.778852, -122.390527 37.780607, -122.389168 37.781649, -122.388423 37.78179799999999, -122.387421 37.78279, -122.383505768697 37.7830792797042, -122.381232 37.773514, -122.380462169293 37.7675163525902, -122.385823 37.767255, -122.387917 37.764379, -122.388164 37.766958, -122.393968 37.766614, -122.393848 37.765307, -122.398703 37.765014, -122.404497 37.764664, -122.40499 37.769715))"
185,"Census Tract 610, San Francisco County, California",92958,93287,329,610.0,"POLYGON ((-122.405582 37.708231, -122.404821 37.709747, -122.404348 37.710443, -122.403109 37.711998, -122.402546 37.712266, -122.400626 37.712984, -122.398328 37.716259, -122.398515 37.717664, -122.397025 37.719515, -122.396682 37.720266, -122.393545 37.718487, -122.391141 37.71803999999999, -122.388131 37.71629799999999, -122.38685 37.717509, -122.386265 37.717179, -122.38282 37.721872, -122.383251 37.720151, -122.374980911262 37.71555763121989, -122.377251 37.714557, -122.379568 37.711491, -122.37529 37.708482, -122.390674 37.70864, -122.39137503156 37.708331, -122.393635 37.708244, -122.395107 37.708339, -122.404682 37.708331, -122.405292 37.708262, -122.405582 37.708231))"
186,"Census Tract 611, San Francisco County, California",14270,18990,4720,611.0,"POLYGON ((-122.408431 37.796704, -122.405513 37.797065, -122.402041 37.797505, -122.400681 37.796777, -122.400149 37.794134, -122.404613 37.793565, -122.404796 37.794453, -122.407903 37.79406, -122.408253 37.795824, -122.408431 37.796704))"
187,"Census Tract 612, San Francisco County, California",43293,59866,16573,612.0,"POLYGON ((-122.395945 37.737784, -122.394093 37.736729, -122.391268 37.739853, -122.389425 37.738803, -122.387705 37.742697, -122.387143 37.741297, -122.385282 37.74024, -122.388529 37.736475, -122.38717 37.735698, -122.387399 37.734738, -122.389035 37.732919, -122.39106 37.734066, -122.391617 37.732487, -122.393904 37.733788, -122.392776 37.735038, -122.396515 37.737156, -122.395945 37.737784))"
188,"Census Tract 614, San Francisco County, California",72143,127813,55670,614.0,"POLYGON ((-122.403784 37.749433, -122.403007 37.752446, -122.403127 37.754478, -122.403396 37.756471, -122.403689 37.757015, -122.39797 37.757359, -122.398216 37.759909, -122.392494 37.760245, -122.392447 37.756436, -122.391232 37.752657, -122.390683 37.752663, -122.394587 37.752427, -122.396408 37.751179, -122.402605 37.750558, -122.403569 37.749475, -122.403784 37.749433))"
189,"Census Tract 615.00, San Francisco County, California",112328,189329,77001,615.0,"POLYGON ((-122.406062 37.785757, -122.399195 37.791058, -122.396315 37.793337, -122.394748 37.79448, -122.393181 37.79323, -122.391487 37.793859, -122.389708268207 37.7958244063587, -122.388570312096 37.7945008753206, -122.385555859095 37.790994833152, -122.385323 37.790724, -122.383505768697 37.7830792797042, -122.387421 37.78279, -122.388423 37.78179799999999, -122.389168 37.781649, -122.390527 37.780607, -122.39275 37.778852, -122.397386 37.782554, -122.39893 37.783785, -122.400468 37.78503, -122.402708 37.783259, -122.406062 37.785757))"
190,"Census Tract 9802, San Francisco County, California",94479,164250,69771,9802.0,"POLYGON ((-122.510781 37.782059, -122.507484 37.782185, -122.509842514521 37.7846145393916, -122.50531 37.788312, -122.493048716406 37.7879341073778, -122.493338 37.787403, -122.493491 37.783498, -122.493446 37.781627, -122.498801 37.781377, -122.502012 37.781227, -122.505226 37.781077, -122.506509 37.780857, -122.509879 37.780627, -122.510781 37.782059))"
191,"Census Tract 9803, San Francisco County, California",125313,0,-125313,9803.0,"POLYGON ((-122.513067688424 37.7707830331714, -122.511124 37.771323, -122.505611 37.771592, -122.498114 37.771934, -122.494903 37.772081, -122.488471 37.772374, -122.482049 37.772667, -122.478837 37.772815, -122.471706 37.773141, -122.466952 37.773351, -122.465332 37.773423, -122.463749 37.773624, -122.460553 37.774031, -122.458371 37.774309, -122.454683 37.774755, -122.454083 37.77193, -122.450787 37.772368, -122.447497 37.77279, -122.444216 37.773212, -122.440922 37.773635, -122.440735 37.772713, -122.445717 37.77208, -122.4506 37.77146, -122.453902 37.771054, -122.453352 37.768246, -122.452947 37.766374, -122.456913 37.765874, -122.45779 37.766015, -122.458405 37.76616, -122.46109 37.766132, -122.464297 37.765963, -122.47073 37.76577899999999, -122.477261 37.765486, -122.484763 37.76516, -122.486906 37.765054, -122.493336 37.764774, -122.496085 37.764675, -122.502979 37.764344, -122.50987 37.76409, -122.512070759187 37.7636593024008, -122.513067688424 37.7707830331714))"
192,"Census Tract 9804.01, San Francisco County, California",0,0,0,9804.01,"POLYGON ((-123.013916 37.700355, -123.007786 37.698943, -123.007548 37.70214, -123.003507 37.704396, -123.000893 37.701011, -122.998754 37.697438, -123.002794 37.692736, -123.005884 37.693489, -123.007548 37.695934, -123.012777 37.696498, -123.013916 37.700355))"
193,"Census Tract 9805.01, San Francisco County, California",17781,17750,-31,9805.01,"POLYGON ((-122.42639 37.718561, -122.42583 37.719302, -122.424771 37.722172, -122.423807 37.723691, -122.421847 37.724199, -122.419875 37.72471, -122.416632 37.722157, -122.412969 37.723858, -122.412468 37.722658, -122.41099 37.719074, -122.407036 37.720085, -122.406665 37.719215, -122.407272 37.71782, -122.408255 37.71809, -122.40895 37.716458, -122.410433 37.716414, -122.411316 37.714367, -122.415396 37.715474, -122.415291 37.713504, -122.415635 37.712733, -122.420908 37.713774, -122.421475 37.712201, -122.422241 37.711317, -122.423027 37.710377, -122.424478 37.71011, -122.426737 37.711225, -122.425548 37.714517, -122.427189 37.715748, -122.42639 37.718561))"
194,"Census Tract 9806, San Francisco County, California",58365,62875,4510,9806.0,"POLYGON ((-122.385024 37.724098, -122.382176 37.722246, -122.377833 37.72656, -122.379697 37.727618, -122.378542 37.728942, -122.373766 37.728005, -122.369771405992 37.7326989677807, -122.367386 37.732004, -122.366161 37.732844, -122.364671 37.731859, -122.356784 37.729505, -122.360238 37.719421, -122.364084 37.715701, -122.370411 37.717572, -122.374980911262 37.71555763121989, -122.383251 37.720151, -122.38282 37.721872, -122.384517 37.722862, -122.386899 37.724289, -122.385024 37.724098))"
195,"Census Tract 9809, San Francisco County, California",149914,0,-149914,9809.0,"POLYGON ((-122.406952 37.740495, -122.40459 37.744126, -122.403561 37.747762, -122.403569 37.749475, -122.402605 37.750558, -122.396408 37.751179, -122.394587 37.752427, -122.390683 37.752663, -122.381711 37.753186, -122.380985 37.753228, -122.378560351096 37.7535517721854, -122.376716 37.752094, -122.376241 37.748523, -122.373364367386 37.7457632793685, -122.376847 37.740192, -122.37911 37.73768, -122.380887 37.738828, -122.381558 37.738123, -122.385282 37.74024, -122.387143 37.741297, -122.387705 37.742697, -122.389425 37.738803, -122.391268 37.739853, -122.394093 37.736729, -122.395945 37.737784, -122.399685 37.739902, -122.406853 37.73805, -122.406952 37.740495))"
